MMMMMMWWW__________
MMM_____WW____c____
MM___v_WWWW___R____
_CRRRRRRRRRRRRR____
___V_____WW________