MMMMMMMMMMMMMMMMMMMMMMMMMMMMMMMMMMMMMMMMMMMMWWWWWWWWWWWWWWWWWWWWWMMMMMMMMMMMMMMMMMMMM
MMMMMMMMMMMMMMMMMMMMMMMMMMMMMMMMMMMMWWWWWWWWWWWWWWWMMMMMMMMMMMMMMMMMMMMMMMMMMMMMMMMMM
MMMMMMMMMMMMMMMMMMMMMMMMMMMMMMMMMWWWWWWMMMMMMMMMMMM_________MMM______MMMMMMMMMMMMMMMM
MMMMMMMMMMMMMMMMMMMMMM________MMRRRRRRRRRRRRRRRRR____________MMM_______MMMMMM__McMMMM
MMMMMMMMMMMMMMMMMMMMM_________RRRMMMMWWWWMMMMMMMRR____________MM________MMMM____R__MM
MMMMMMMMMMMMMMMMWMM___________R_MMMMMMMWWWWMMMMMMRR___________MMM______MMMMRRRRRR__MM
MMMMMMMMMMMMMMMWWW___________RR___MMMMMMWWWMMM____RRRRRRRRRR__MM__RRRRRRRRRRM___R__MM
MMMMMMMMMMMMMM__WWW_________RR_______MMWWMMMM______________RRRRRRRR____MMMMMM___RRvMM
MMMMMMMMMMMMM__WWWW_________R_________WWMMMM__________________M___________MMMMRRR__MM
MMMMMMMMMMMMMMMWWWW_________R_________WWWMM__________________MMM____________MMRMMMMMM
MMMMMMMMMMMMMMMMWW__________R___________WW____________________MM______________R_MMMMM
MMMMMM____MMMMM__WWW________R____________WWW__________________MMM_____________R_MMMMM
MMMMMM_____MMMM____W________R___________WWWWW__________________MMMM___________R__MMMM
MMMMM________MMMM___________R____________WWWWW____________________MMMMMMM_____R___MMM
MMM____________MM___________R__________WWWWWW_______________________RRRRRRRRRRR___MMM
M______________MMM____W_____R___________WWWWW_____________RRRRRRRRRRR_________R____MM
________________MMMM__WW____R______RRRRRRRRRRRRRRRRRRRRRRRR___________________R____MM
M_________________MMM___W___RRRRRRRR___WWWWWWW_______________________________RR____MM
MM___V_______________RRRRRRRR_________WWWWWWWWWW_____________________________R_____MM
M____R_______________R___W________________WWWWWWWWWW_________________________R_____MM
_____R_______________R___W_______________WWWWWWWWWWWW_______________________RR______M
__RRRRRRRR___________R___WW____________WWWWWWWWWWWWWWWWW____________________R_______M
__CMM____RRRRRR___RRRR____WW________WWWWWWWWW___WWWWWWWWW___________________R________
MMMMMMM_______RRRRR_______WW___WWWWWWWWWWW________WWWWWWWWWW________________R________
_MMMM_____________RRRRRRWWWWWWWWWWWW_____________WWWWWWWWWWWWWWW____________R________
______________________WRWWWWWWWWWW______RRRRRRRRRRRRRR_____WWWWWWWWWWWWWWW__R________
_____________________WWRWWWW____RRRRRRRRR____________RRRRRR_____WWWWWWWWWWWWRWWWWWWW_
_WWWWWWWWWWWWWWWWWWWWWWRWWW_____R_________________________RRRRR_______WWWWWWRWWWWWWWW
WWWWWWWWWWWWWWWWWWWWW__RRRRRRRRRR_____________________________RRRRRRRRRRRRRRR_WWWWWWW
WWWWWWWWWWWWW___________________________________________________________________WWWWW
WWWWWW_____________________________________________________________________________WW