MMMMMMMMMMMMMMMMMMMMMM________MMMMMMM
MMMMMMMMMMMMMMMMMMMMM_________MMMMMMM
MMMMMMMMMMMWMM_____________MMMMMMMWWW
MMMMMMMMMMWWW________________MMMMMMWW
MMMMMMMMM__WWW____________c____MMWWMM
MMMMMMMM__WWWW____________R______WWMM
MMMMMMMMMMWWWW____________R______WWWM
MMMMMMMMMMMWW__________RRRRRRRv____WW
MMM____MMM__WWW________R____________W
MMMM____MM____W________R___________WW
MMMM___________________R____________W
MMM____________________R__________WWW
M__________MM____W_____R___________WW
___________MMMM__WW____R____________W
M____________MMM___W___RRRRRRRRR__WWW
MM___V__________RRRRRRRR_______R_WWWW
M____R__________R___W__________R__WWW
_____R__________R___W__________R__WWW
__RRRRRRRR______R___WW_________R__WWW
__CMM____RRRRRRRR____WW________RWWWWW
MMMMMM______R_______WW___WWWWWWRWWWW_
_MMMM_______RRRRRRRWWWWWWWWWWWWR_____
_________________WRWWWWWWWWWW__R_____
________________WWRRRRRRRRRRRRRR_____
_WWWWWWWWWWWWWWWWWWWWW_______________