MMMMMMMMMMWWWMMMMMMMMMMMWM
MMMMMMMMM__WWWMMMM__c_MMMW
MMMMMMMM__WWWWMM____R___MW
MMMMMMMMMWWWW__MM___R_MMWM
MMMMMMMMMMMWW___M___RRv_WM
M___MM____W_____M___R___WW
_____MMMM__WW_______R____W
M_____MMM___W___RRRRR___WW
MM___V___RRRRRRRR___R__WMM
M____RRRRR__WW______R__WMM
_____R_______W______R__WWM
__RRRRRRR___WWW_____R__WW_
__CMM___RRRRRRRRRRRRRWWWWW
MMMMM________WWW___WWWWMMM